111111111
100C00001
111111111
1PC0CCCE1
111111111
