1111111111111111111111111111111111
1000000000000000000C00001000000001
1000000000000000000000001000000001
1000000000000000000000001000000001
10000000000000000000P000000000C0E1
1111111111111111111111111111111111
