1111111111111111111111111111111111
1E0000000F00000C00000C000000000001
10100101001000001F1001000000010101
1110010010101010001001000000010101
1P100F000C00C0000F00000000F00000C1
1111111111111111111111111111111111
