111111111
100C00F01
10CCCC001
1PC0CCCE1
111111111
