11111
1PC01
10111
101E1
11111
