111111111
100C00001
111011111
1PC0CCCE1
111111111
