111111111
100C00001
100CCC001
1PC0CCCE1
111111111
