11111111111
10000000001
1000P000001
10000000001
1000E000001
10000000001
100000C0001
11111111111
